reliavility engineer

tcp


logesh - infosys

padhu k - hcl tech

aman chanana - ey java aws

anshu  singh  - ganit

meheli hupta - proclink

sanju 1413 - ey aws java

shashank gupta - incubit
pankaj kumar - zenon
sanchi jain - team computers

LP Dheeraj - infosys as client

pari sharma - Iris Software

tech elite solutions priyank - incedo

madhu arun vipany - ihs markit etl developer

bhanu sykam - Virtusa - aws developer

shubham gupta - incedo technologies

kavita yadav - SupplyCopia

hanuman reddy - smart cube

baijnath choudhary - R1 RCM

Saurav S - GlobalLogic 

nii nii - globallogic

manjushree shetty - globallogic

mounika g - tech mahindra aws java python

pooja hr - scala developer

akanksha srivastava - incedo aws developer

mouli it recruiter - EY 22 f 20 var

madhuri - infogain kafka etl

EIT EIT

richa chadda - vichara technologies aws python

krishna dave - koentek

shruti mehrotra - paytm recruiter new contact inplace of chanchala share resignation acceptance letter


Mahima Kumari - ITC Infotech


